NO ./textures/north_texture.xpm
SO ./textures/south_texture.xpm
WE ./textures/west_texture.xpm
EA ./textures/east_texture.xpm

F 220,100,0
C 225,30,0



111111111111111111
10000N0000000000001
1111111111111111110